..............................................................................
..............................................................................
..............................................................................
..............................................................................
..............................................................................
.....##########..........############.......##########..........############..
.....##########..........############.......##########..........############..
..............................................................................
..............................................................................
..............................................................................
............................................##########..........############..
............................................##########..........############..
...........############.......................................................
...........############.......................................................
..............................................................................
..............................................................................
..............................................................................
..............................................................................
.........................##########...........................................
.........................##########...........................................
...........##.................................................................
..........####................................................................
.........######...............................................................
........####.###.............................................................
##############################################################################
##############################################################################
##############################################################################
##############################################################################
##############################################################################
##############################################################################
##############################################################################
##############################################################################